NO ./texture/no.xpm
SO ./texture/so.xpm
WE ./texture/we.xpm
EA ./texture/ea.xpm

F 220,100,0
C 225,30,0

        1111111111111111111111111
        10000000000000000000000001
        100000000000000000W0000001
        10000000000000001000000001
1111111110000000000000000101000011
100000000000000000000000000011111
1111000000000000000000000100011      
11110111111111011101010010001
11000000110010000000000100011    
100000000001 10001100000010001    
11111111111111111110000001111     
11110111111111011100000000001    
11110111111111011101010010001    
11000000110101011100000010001    
10000000000000001100000010001
11111111111111111111111111111   
  
    
      
















































